111111111111111111111111111
1....1...1...1...1...1....1
1..2...1...1...1...1.1....1
11111111111111111111.1....1
1.........................1
111111111.11111111111111111
1.......1....1............1
1.......1#...1111.111111111
1.........................1
1.......1....1............1
111111111.11111111111111111
1.......1.............1...1
1...2ф...1.............1...1
1.......1.............1...1
1..111111.............1...1
1.......1.............1...1
1.1111111.............1...1
1.......1.............1...1
1.........................1
111111111111111111111111111