111111111111111111111
1.......1.1....1....1
1.......1.1....1....1
1111.1111.11.11111.11
1...................1
111111111.11111111111
1......1...1........1
1......1.#21....2...1
1......1...1........1
111..111...1111.11111
1...................1
1......1...1........1
11111111...1111111111
1......1...1........1
1......1...1...1....1
1......1...1...1....1
1...2..1...1...1.2..1
1111.111...1...1....1
1..............1....1
111111111111111111111